D 5 3 9 5 5 5 5 3 9 3 9 1 5 5 5 3 D 5 3
9 5 6 A 9 5 1 7 C 6 A E A 9 5 7 C 5 3 A
A 9 3 A A 9 6 9 5 5 2 9 6 A 9 5 3 9 6 A
C 6 A A E C 5 6 9 3 C 6 D 4 2 B A A 9 2
9 5 6 8 3 9 5 5 6 C 5 3 9 3 C 6 8 6 E A
C 5 3 E C 2 9 3 9 5 3 A A C 5 3 A 9 5 2
D 3 C 5 3 C 6 E A B A C 4 5 7 A 8 6 D 6
9 4 3 B C 5 5 1 6 A C 5 5 5 3 A E 9 5 3
A D 2 8 3 F B A F 8 7 F F F A 8 3 A 9 2
8 3 A A A F C 6 F C 1 5 7 F A E 8 6 A A
E A A A A F F F F F A F F F C 3 C 3 A E
9 6 A A A 9 5 3 F 9 2 F D 5 3 A 9 6 C 3
A D 4 6 E A B A F E A F F F A A E 9 5 2
A 9 5 5 5 6 A C 5 1 2 9 5 5 2 C 3 C 3 A
A A 9 1 7 9 4 1 7 A E C 3 9 4 7 A 9 6 A
8 6 E C 1 4 7 C 3 C 5 3 A C 3 9 6 A D 2
C 5 5 3 A B 9 3 C 1 3 C 6 B C 6 9 4 3 A
9 7 9 6 C 6 A C 3 E C 1 3 C 1 3 E 9 6 A
8 3 C 5 3 9 6 B C 3 9 6 C 5 6 C 3 C 3 A
E C 5 5 4 6 D 4 5 4 6 D 5 5 5 5 4 5 6 E
0,0
9,9
EESWWSSENESSWWSEESEESEEEENNEESSEEEESSSESSSESSWSWNWNENWWWSESSWNWWNNENNNNW
